ref_kmer	IUPAC	modif	enzyme
UGUAA	UNUAR	pseudoU	PUS7
UGUAG	UNUAR	pseudoU	PUS7
UCUAA	UNUAR	pseudoU	PUS7
UCUAG	UNUAR	pseudoU	PUS7
UAUAA	UNUAR	pseudoU	PUS7
UAUAG	UNUAR	pseudoU	PUS7
UUUAA	UNUAR	pseudoU	PUS7
UUUAG	UNUAR	pseudoU	PUS7
GUUAAA	GUUNNA	pseudoU	TRUB1
GUUAUA	GUUNNA	pseudoU	TRUB1
GUUACA	GUUNNA	pseudoU	TRUB1
GUUAGA	GUUNNA	pseudoU	TRUB1
GUUGAA	GUUNNA	pseudoU	TRUB1
GUUGUA	GUUNNA	pseudoU	TRUB1
GUUGGA	GUUNNA	pseudoU	TRUB1
GUUGCA	GUUNNA	pseudoU	TRUB1
GUUCAA	GUUNNA	pseudoU	TRUB1
GUUCGA	GUUNNA	pseudoU	TRUB1
GUUCCA	GUUNNA	pseudoU	TRUB1
GUUCUA	GUUNNA	pseudoU	TRUB1
GUUUAA	GUUNNA	pseudoU	TRUB1
GUUUCA	GUUNNA	pseudoU	TRUB1
GUUUUA	GUUNNA	pseudoU	TRUB1
GUUUGA	GUUNNA	pseudoU	TRUB1
UA	UA	pseudoU	PUS1


